OOOOOOOOOOOOOOOO
OOOOOOOOOOOOOOOO
OOOOOOOOOOOOOOOO
OOOOOOOOOOOOOOOO
OOOOOOOOOOOOOOOO
OOOOOOOOOOOOOOOO
OOOOOOOOOOOOOOOO
OOOOOOOOOOOOOOOO
OOOOOOOOOOOOOOOO
OOOOOOOOOOOOOOOO
XXXXXXXXXXXXXXXX
OOXOOOXOOOXOOOOX
OOOOOOOOOOOOOOOO
XOOOXOOOXOOOXXOO
XXXXXXXXXXOOXXXX
XXXXXXXXXXXXXXXX
