OOOOOOOOOOOOOOOO
OOOOOOOOOOOOOOOX
OOOOOOOOOOOOOXXX
OOOOOOOOOOOXXXXX
OOOOOOOOXXXXXXXX
OOOOOXXXXXXXXXXX
XXXXXXXXXXXXXXXX
XXXXXXXXXXXXXXXX
XXXXXXXXXXXXXXXX
XXXXXXXXXXXXXXXX
XXXXXXXXXXXXXXXX
XXXXXXXXXXXXXXXX
XXXXXXXXXXXXXXXX
XXXXXXXXXXXXXXXX
XXXXXXXXXXXXXXXX
XXXXXXXXXXXXXXXX
