OOOOOOOOOOOOOOOO
XOOOOOOOOOOOOOOO
XXXOOOOOOOOOOOOO
XXXXXOOOOOOOOOOO
XXXXXXXXOOOOOOOO
XXXXXXXXXXXOOOOO
XXXXXXXXXXXXXXXX
XXXXXXXXXXXXXXXX
XXXXXXXXXXXXXXXX
XXXXXXXXXXXXXXXX
XXXXXXXXXXXXXXXX
XXXXXXXXXXXXXXXX
XXXXXXXXXXXXXXXX
XXXXXXXXXXXXXXXX
XXXXXXXXXXXXXXXX
XXXXXXXXXXXXXXXX
