OOOOOOOOOOOOOXXX
OOOOOOOOOOOOOXXX
OOOOOOOOOOOOOXXX
OOOOOOOOOOOOOXXX
XXXXXXXXXXXXXXXX
OOOOOOOOOOOOOOOO
OOOOOOOOOOOOOOOO
XXXXXXXOOOOOOOOO
XXXXXXXXXOOOOOOO
XXXXXOOOOOOOXOOO
XXXXOOOOOOOOXXOO
OOOOOOOXXXXXXXXX
OOOOOOXXXXOOXXXX
OOOOXXXXXXOOXXXX
XXXXXXXXXXOOXXXX
XXXXXXXXXXXXXXXX
