OOOOOOOOOOOOOOOO
OOOOOOOOOOOOOOOO
OOOOOOOOOOOOOOOO
OOOOOOOOOOOOOOOO
OOOOOOOOXXOOOOOO
OOOOOOOOXXOOOOOO
OOOOOOOOXXOOOOOO
OOOOOOXXXXOOOOOO
OOOOOOOOOOOOXOOO
OOOOOOOOOOOOXOOO
OOOOOOOOOOOOXOOO
XXXXXXXXXXOOXOOO
XXXXXXXXXXOOXOOO
XXXXXXXXXXOOXOOO
XXXXXXXXXXOOXOOO
XXXXXXXXXXXXXXXX
